.
.
...bbb...bbb...bbb...bbb...bbb...bbb...
GGG...GGG...GGG...GGG...GGG...GGG...GGG
...ooo...ooo...ooo...ooo...ooo...ooo...
WWW...WWW...WWW...WWW...WWW...WWW...WWW
...yyy...yyy...yyy...yyy...yyy...yyy...
BBB...BBB...BBB...BBB...BBB...BBB...BBB
...GGG...GGG...GGG...GGG...GGG...GGG...
ooo...ooo...ooo...ooo...ooo...ooo...ooo
...WWW...WWW...WWW...WWW...WWW...WWW...
.
....xxx....xxx....xxx....xxx....xxx....