.
.
...bbbBBBbbbBBBbbbBBBbbbBBBbbbBBBbbb...
...gggGGGgggGGGgggGGGgggGGGgggGGGggg...
...oooOOOoooOOOoooOOOoooOOOoooOOOooo...
...wwwWWWwwwWWWwwwWWWwwwWWWwwwWWWwww...
...yyyYYYyyyYYYyyyYYYyyyYYYyyyYYYyyy...
...bbbBBBbbbBBBbbbBBBbbbBBBbbbBBBbbb...
.
.
.
.
....xxx....xxx....xxx....xxx....xxx....